**************
***********B**
****** **** ***
****** **** ***
******      *******
**     *** *********
** ******* ******
**A        ***********
**************
