*****
****B*
*    *
*A****
*****








